#######################################
# Syntax Coloring Map
#######################################

#######################################
# Datatypes (KEYWORD1)
#######################################

DisplayInterface	KEYWORD1
ItemSubMenu	KEYWORD1
ItemToggle	KEYWORD1
LiquidCrystalI2CAdapter	KEYWORD1
ItemCommand	KEYWORD1
ItemInput	KEYWORD1
LiquidCrystalAdapter	KEYWORD1
ItemList	KEYWORD1
ItemFooter	KEYWORD1
MenuItem	KEYWORD1

#######################################
# Methods and Functions (KEYWORD2)
#######################################

setValue	KEYWORD2
increment	KEYWORD2
isAtTheEnd	KEYWORD2
getMaxRows	KEYWORD2
drawUpIndicator	KEYWORD2
processMenuCommand	KEYWORD2
processCommand	KEYWORD2
back	KEYWORD2
getItems	KEYWORD2
setProgress	KEYWORD2
drawMenu	KEYWORD2
getCallback	KEYWORD2
resetBlinker	KEYWORD2
float	KEYWORD2
backspace	KEYWORD2
hide	KEYWORD2
drawChar	KEYWORD2
getType	KEYWORD2
setItemIndex	KEYWORD2
getMaxCols	KEYWORD2
getValue	KEYWORD2
drawDownIndicator	KEYWORD2
getCallbackInt	KEYWORD2
reset	KEYWORD2
drawMenu	KEYWORD2
getTextOn	KEYWORD2
isSubMenu	KEYWORD2
left	KEYWORD2
getItemIndex	KEYWORD2
resetMenu	KEYWORD2
drawCursor	KEYWORD2
down	KEYWORD2
getEditModeEnabled	KEYWORD2
decrement	KEYWORD2
setCursorPosition	KEYWORD2
updateTimer	KEYWORD2
processWithSimpleCommand	KEYWORD2
getTextOn	KEYWORD2
long	KEYWORD2
isAtTheStart	KEYWORD2
charsetPosition	KEYWORD2
getCallbackStr	KEYWORD2
enter	KEYWORD2
getItemAt	KEYWORD2
setIsOn	KEYWORD2
initialize	KEYWORD2
isOn	KEYWORD2
getCallbackInt	KEYWORD2
update	KEYWORD2
begin	KEYWORD2
DisplayInterface	KEYWORD2
processWithRotaryEncoder	KEYWORD2
isSubMenu	KEYWORD2
getTextOff	KEYWORD2
clear	KEYWORD2
getCursorPosition	KEYWORD2
right	KEYWORD2
reset	KEYWORD2
type	KEYWORD2
void	KEYWORD2
setEditModeEnabled	KEYWORD2
up	KEYWORD2
left	KEYWORD2
show	KEYWORD2

#######################################
# Constants (LITERAL1)
#######################################

ITEM_PROGRESS	LITERAL1
EDIT_CURSOR_ICON	LITERAL1
DISPLAY_TIMEOUT	LITERAL1
MAX_PROGRESS	LITERAL1
MAIN_MENU	LITERAL1
MIN_PROGRESS	LITERAL1
ITEM_COMMAND	LITERAL1
ITEM_INPUT	LITERAL1
ITEM_STRING_LIST	LITERAL1
ITEM_TOGGLE	LITERAL1
MENU_SCREEN	LITERAL1
EDIT_CURSOR_ICON	LITERAL1
DISPLAY_TIMEOUT	LITERAL1
MIN_PROGRESS	LITERAL1
CURSOR_ICON	LITERAL1
ITEM_BASIC	LITERAL1
MAX_PROGRESS	LITERAL1
ITEM_PROGRESS	LITERAL1
